# SIMPLE WORDS
refresh :: Refresh
search :: Search
add :: Add
clear :: Empty Fields
return :: Return
exit :: Exit
data :: Data
books :: Books
locations :: Locations
loans :: Loans
help :: Help
everything :: All
new :: New
modify :: Modify
delete :: Delete
loan :: Loan
returns :: Returns

# System
menu :: Menu
saveData :: Save data
about :: About
welcomeLabel :: WELCOME TO YOUR FAMILY LIBRARY
confirmExit:: Exit the program?
confirmExitHeader::Exit program
saveData::Save copy of data?
saveDataHeader::Confirm Data Copy
successfulSave::Files succesfully saved
successfulSaveHeader::Files Saved
aboutInfo::Library Management Software || Version: 0.1.1 || Samuel Movi [ github.com/samuelmovi ]
aboutInforHeader::About Family Library
fillModelX::Error refreshing samuelmovi.familyLibraryJava.model
fillModelXHeader::Refreshing Error

# BOOK STUFF
booksTotalLabel :: Books total:
pendingLoansLabel :: Pending loans:
bookViewAliases :: Title/Author/Genre/Publisher/ISBN/Published/Acquired/Location/Loaned/Registered/Modified
bookFieldAlias :: ID/Title/Author/Genre/Publisher/ISBN/Published/Acquired/Location/Loaned/Registered
searchBookFields :: Title/Author/Genre/Publisher/ISBN
bookLabelsText :: Title,Author,Genre,Publisher,ISBN,Published,Acquired,Location
refreshBookTablesX::Error refreshing book tables
refreshBookTablesXHeader::Refreshing Error
searchBooksX::Error searching for book
searchBooksXHeader::Search Error
deleteBookC::Delete book from database?
deleteBookCHeader::Confirm Deletion
deleteBookX::ID is not correct
deleteBookXHeader::Deletion Error
returnBook::Loan ID is incorrect
returnBookH::Return Error
addBookC::Book added to database
addBookCHeader::Book added
addBookX::Book wasn't correctly added
addBookXHeader::Error
modifyBookC::Book correctly modifies
modifyBookCHeader::Modifies Book
modifyBookX:: Error modifying book
modifyBookXHeader::Modification Error 
deleteBookC::Delete book titled '
deleteBookCHeader::Confirm Deletion

# LOCATION STUFF
locationFieldAlias :: ID/Address/Room/Loaned/Returned
locationLabelsText :: Address,Room,Loaned,Returned
refreshLocationTablesX::Error refreshing location tables
refreshLocationTablesXHeader::Refresh Error
addLocationC::Location correctly added to database
addLocationCHeader::Location added
addLocationX::Error adding location to database
addLocationXHeader::Error
modifyLocationC::Location correctly modifies
modifyLocationCHeader::Location modified
modifyLocationX::Error modifying location
modifyLocationXHeader::Modification Error
deleteLocationC::Delete selected location?
deleteLocationCHeader::Confirm Deletion

# LOAN STUFF
loanFieldALias :: ID/Book/Borrower/Loaned/Returned
loanLabelsText :: Book ID,Loaned to
loanIdLabel :: Loan ID
refreshLoanTablesX::Error refreshing loan tables
refreshLoanTablesXHeader::Refresh Error
loanBookQ:: Loan book titles '
loanBookQHeader::Confirm Loan
loanBookC::Loan registered to the database
loanBookCHeader::Loan registered
loanBookX::Loan wans't correctly processed
loanBookXHeader::Error
returnBookC::Confirm book return
returnBookCHeader::Confirm return
